7571611157161115
4000540000270008
4000000000000035
9A00000000000059
4100030008400002
A000270001000002
700840033002A002
4031002754001002
4054002A84000002
40002A0110030002
4840010000270002
4100300000302A08
A000540000540105
7000003000008402
4000027000001002
A338A33338A33338