7571611111576115
4302700000027002
45400000000002A2
40000089A0000012
4000001010000008
A000000008430005
702A000331054002
4001002754000002
4000002A84000002
4008400110000008
A001030084000305
7000270010002702
4000000000000002
9A00003027000032
4100005401000059
A3338A333338A338